NO textures/north.png

SO  ./textures/south.png

            C    0 ,  125,            255

EA  textures/east.png
WE  textures/west.png
                 
 F       255 , 50,0

1111111111111111111111111
100001000011000000111111111
111111000111000000000000001
10100000000000000000000000011111111111111111111111111111
11111111101100000000N000000100000000000000000000000111
1000000000111100000000000001000000000000000000000011111111
1111011111111111011100000111111111111111111111111111111
1111111111111111111111111